inherit=fonts\rodondo_EngSym.txt
inherit=fonts\rodondo_ArabicNum.txt
а=fonts\rodondo\A
б=fonts\rodondo\RUS_Beh
в=fonts\rodondo\B
г
д
е=fonts\rodondo\E
ё=fonts\rodondo\E_DD
ж
з=fonts\rodondo\3
и=fonts\rodondo\INV_N
й=fonts\rodondo\INV_N_CTRo
к=fonts\rodondo\K
л
м=fonts\rodondo\M
н=fonts\rodondo\H
о=fonts\rodondo\O
п
р=fonts\rodondo\P
с=fonts\rodondo\C
т=fonts\rodondo\T
у=fonts\rodondo\RUS_Y
ф
х=fonts\rodondo\X
ц
ч
ш
щ
ъ
ы
ь
э=fonts\rodondo\INV_CWL
ю
я=fonts\rodondo\INV_R