ä=fonts\rodondo\A_DD
`=fonts\rodondo\Circumflex
~=fonts\rodondo\Tilde
^=fonts\rodondo\Caret
¿=fonts\rodondo\Invert-QM
à=fonts\rodondo\A_CF
á=fonts\rodondo\A_CFR
â=fonts\rodondo\A_CT
ã=fonts\rodondo\A_TD
å=fonts\rodondo\A_Crl
æ=fonts\rodondo\AE
ç=fonts\rodondo\C_BWP
è=fonts\rodondo\E_CF
é=fonts\rodondo\E_CFR
ê=fonts\rodondo\E_CT
ë=fonts\rodondo\E_DD
ì=fonts\rodondo\I_CF
í=fonts\rodondo\I_CFR
î=fonts\rodondo\I_CT
ï=fonts\rodondo\I_DD
ò=fonts\rodondo\O_CF
ó=fonts\rodondo\O_CFR
ô=fonts\rodondo\O_CT
õ=fonts\rodondo\O_TD
ö=fonts\rodondo\O_DD
Ø=fonts\rodondo\ST_O
ù=fonts\rodondo\U_CF
ú=fonts\rodondo\U_CFR
û=fonts\rodondo\U_CT
ü=fonts\rodondo\U_DD
ý=fonts\rodondo\Y_CFR
ß=fonts\rodondo\WB