inherit=fonts\rodondo_EngSym.txt
inherit=fonts\rodondo_ArabicNum.txt
а=fonts\rodondo\A
б=fonts\rodondo\RUS_Beh
в=fonts\rodondo\B
г=fonts\rodondo\RUS_Geh
д=fonts\rodondo\RUS_Deh
е=fonts\rodondo\E
ё=fonts\rodondo\E_DD
ж=fonts\rodondo\RUS_Zheh
з=fonts\rodondo\3
и=fonts\rodondo\RUS_Ee
й=fonts\rodondo\RUS_EeKratkoyeh
к=fonts\rodondo\K
л=fonts\rodondo\RUS_Ehl
м=fonts\rodondo\M
н=fonts\rodondo\H
о=fonts\rodondo\O
п=fonts\rodondo\RUS_Peh
р=fonts\rodondo\P
с=fonts\rodondo\C
т=fonts\rodondo\T
у=fonts\rodondo\RUS_Oo
ф=fonts\rodondo\RUS_Ehf
х=fonts\rodondo\X
ц=fonts\rodondo\RUS_Tseh
ч=fonts\rodondo\RUS_Cheh
ш=fonts\rodondo\RUS_Shah
щ=fonts\rodondo\RUS_Schyah
ъ=fonts\rodondo\RUS_TvyordiyZnahk
ы=fonts\rodondo\RUS_I
ь=fonts\rodondo\RUS_MyagkeeyZnahk
э=fonts\rodondo\RUS_Eh
ю=fonts\rodondo\RUS_Yoo
я=fonts\rodondo\RUS_Yah